1111111111111111111
10000011110C00P0001
10111000000C0111101
1000111111110111101
1111100100000000111
10000C0000000E100C1
1111111111111111111