111111111111111111111111111
10000011110C000000000001001
10111000000C01111010C0C1C01
100011111111011110100000011
111110010000000011100010001
10000C00000000100C100010001
10000011110C00P000100010C01
10111000000C011110100010001
100011111111011110100000001
111110010000000011100011101
10000C00000000100C1000110E1
111111111111111111111111111
